######
# .  #
# $  #
#    #
# @  #
######