######
#    #
# .  #
# $  #
# @  #
######